level:400 29
d
0000000000000000000000000000000000000000000000000000000000000000000000000000000000000000000000000000000000000000000000000000000000000000000000000000000000000000000000000000000000000000000000000000000000000000000000000000000000000000000000000000000000000000000000000000000000000000000000000000000000000000000000777777777777777777777777777777777777777777777777777777777777777777777777777777777777777777
0000000000000000000000000000000000000000000000000000000000000000000000000000000000000000000000000000000000000000000000000000000000000000000000000000000000000000000000000000000000000000000000000000000000000000000000000000000000000000000000000000000000000000000000000000000000000000000000000000000000000000000000777777777777777777777777777777778888888888888888888888888888888888888888888888888888887777
0000000000000000000000000000000000000000000000000000000000000000000000000000000000000000000000000000000000000000000000000000000000000000000000000000000000000000000000000000000000000000000000000000000000000000000000000000000000000000000000000000000000000000000000000000000000000000000000000000000000000000000000777777777777777777777777777777770000000000000000000000000000000000000000000000000000007777
0000000000000000000000000000000000000000000000000000000000000000000000000000000000100000000000000000000000000000000000000000000000000000000000000000000000000000000000000000000000000000000000000000000000000000000000000000000000000000000000000000000000000000000100000000000000000000000000000000000000000000000000777777777777777777777777777777770000000000000000000000000000000000000000000000000000007777
0000000000000000000000000000000000000000000000000000000000000000000000000000000000000000000000000000000000000000000000000000000000000000000000000000000000000000000000000000000000000000000000000000000000000000000000000000000000000000000000000000000000000000000000000000000000000000000000000000000000000000000000777777777777777777777777777777770000000000000000000000000000000000000000000000000000007777
0000000000000000000000000000000000000000000000000000000000000000000000000000000000340000000000000000000000000000000000000000000000000000000000000000000000000000000000000000000000000000000000000000000000000000000000000000000000000000000000000000000000000000022222222223400000000000000000000000000000000000000000777777777777777777777777777777770000000000000000000000000000000000000000000000000000007777
0000000000000000000000000000000000000000000000000000000000000000000000000000000000560000000000000000000000000000000000000000000000000000000000000222222222234000000000000000000000000000000000000000000000000000000000000000000000000000000000000000000000000000000000000005600000000000000000000000000000000000000000777777777777777777777777777777770000000000000000000000000000000000000000000000000000007777
0000000000000000000000000000000000000000000000000000000000000000000000000000000000560000000000000000000000000000000000000000000000000000000000000000000000056340000000000010000000000000000000000000000000000000000000000000000000000000000000000000000000000000000000000005600000000000000000000000000000000000000000777777777777777777777777777777770000000000000000000000000000000000000000000000000000007777
0000000000000000000000000000000000000000000000000000000000000000000000000000000000560000000000000000000000000000000000000000000000222222222220000000000000056563400000000000000000000000000000000000000000000000000000000000000000000000000000000000000000000000000000000005600000000000000000000000000000000000000000777777777777777777777777777777770000000000000000000000000000000000000000000000000000007777
0000000000000000000000000000000000000000000000000000000000000000000000000000000000560000000000000000000000000000000000000222222200000000000000000000000000056565634000000000000000000000000000000000000000000000000000000000000000000000000000000000000000000000000000000002222222222000000000000000000000000000000000777777777777777777777777777777770000000000000000000000000000000000000000000000000000007777
0000000000000000000000000000000000000000000000000000000000000000000000000000000000560000000000000000000000000000000000000000000000000000000000000000000000056565656340000000000000000000000000000000000000000000000000000000000000000000000000000000000000000000000000000000000000000000010000000000000000000000000000777777777777777777777777777777770000000000000000000000000000000000000000000000000000007777
0000000000000000000000000000000000000000000000000000000000000000000000000022222222222222222200000001000000000000000000000000022000000000000000000000000000056565656563400000000000000000000000000000000000000000000000000000000000000000000000000000022222222222222222200000000000000000000000000000000000000000000000777777777777777777777777777777770000000000000000000000000000000000000000000000000000007777
0000000000000000000000000000000000000000000000000000000000000000000000000000000000000000000000000000000000000000000000000000000000000000000000000000000000056565656565634000000000000000000000000000000000000000000000000000000000000000000000000000000000000000000000000000000000000002222200000000000000000000000000777777777777777777777777777777770000000000000000000000000000000000000000000000000000007777
0000000000000000000000000000000000000000000000000000000000000000000000000000000000000000000000222222222222000000000000000000022000000000000000000000000000056565656565656340000000000000000000000000000000000000000000000000000000000000340000000000000000000000000000000000000000000000000000000000000000000000000000777777777777777777777777777777770000000000000000000000000000000000000000000000000000007777
0000000000000000000000000000000000000000000000000000000000000000000000000000000000000000000000000000000000000000000000000000000000000000000000000000000000056565656565656563400000000000000000100000000000000000000000000000000000000000562222222222200000000000000000000000000000000000000000000000000000000000000000777777777777777777777777777777770000000000000000000000000000000000000000000000000000007777
0000000000000000000000000000000000000000000000000000000000000000000000000000000000000000000000000000000022222222222000222222222222222200000000000000000000056565656565656565634000000000000000000000000000000000000000000000000000000000560000000000000000000000000000000000000000000000000000000000000000000000000000777777777777777777777777777777770000000000000000000000000000000000000000000000000000007777
0000000000000000000000000000000000000000000000000000000000000000000000000000000000000000000000000000000000000000000000000000000000000000000000000000000000056565656565656565656340000000000000000000000000000000000000000000000000000000560000000000000000000000000000000000000000000000000000000000000000000000000000777777777777777777777777777777770000000000000000000000000000000000000000000000000000007777
0000000000000000000000000000000000000000000000000000000000000000000000000000000000000000000222222222222220000000000000000000000000000000000000000000000000056565656565656565656563400000000000000000000000000000000000000000000000000000560000000000002222222200000000000000010000000000000000000000000000000000000000777777777777777777777777777777770000000000000000000000000000000000000000000000000000007777
0000000000000000000000000000000000000000000000000000000000000000000000000000000000000000000000000000000000000000000000000000000000000000000000000000000000056565656565656565656565634000000000000000000000000000000000000000000000000000560000000000000000000000000000000000000000000000000000000000000000000000000000777777777777777777777777777777770000000000000000000000000000000000000000000000000000007777
0000000000000000000000000000000000000000000000000000000000000000000000000000022222222222200000000000000000000000000000000000000000000000000000000000000000056565656565656565656565656340000000000000000000000000000000000000000000000000560000000000000000000002220000002222222220000000000000000000000000000000000000777777777777777777777777777777770000000000000000000000000000000000000000000000000000007777
0000000000000000000000000000000000000000000000000000000000000000000000000000000000000000000000000000000000000000000000000000000000000000000000000000000000056565656565656565656565656563400000000000000000000000000000000000000000000000560000000000000000000000000000000000000000000000000000000000000000000000000000000000000000000000000000000000000000000000000000000000000000000000000000000000000000007777
0000000000000000000000000000000000000000000000000000000000000000222222222222222200000000000000000000000000000000000000000000000000000000000000000000000000056565656565656565656565656565634000000000000000000000000000000000000000000000560000000000000000000000000000000000000000000000000000000000000000000000000000000000000000000000000000000000000000000000000000000000000000000000000000000000000000007777
0000000000000000000000000000000000000000000000000000000000000000000000000000000000000000000000000000000000000000000000000000000000000000000000000000000000056565656565656565656565656565656340000000000000000000000000000000022222222222220000000000000000000000000000000000000000000000000000000000000000000000000000000000000000000000000000000000000000000000000000000000000000000000000000000000000000007777
0000000000000000000000000000000000000000000000000002222222222200000000000000000000000000000000000000000000000000000000000000000000000000000000000000000000056565656565656565656565656565656563400000000000000000000000000000000000000000000000000000000000000000000000000000000000000000000000000000000000000000000000000000000000000000000000000000000000000000000000000000000000000000000000000000000000007777
0000000000000000000000000000000000000000000000000000000000000000000000000000000000000000000000000000000000000000000000000000000000000000000000000000000000056565656565656565656565656565656565634000000000000000222222220000000000000000000000000000000000000000000000000000000000000000000000000000000000000000000000000000000000000000000000000000000000000000000000000000000000000000000000000000000000007777
0000000000000000000000000000000000000022222222222000000000000000000000000000000000000000000000000000000000000000000000000000000000000000000000000000000000056565656565656565656565656565656565656000000000000000000000000000000000000000000000000000000000000000000000000000000000000000000000000000000000000000000000000000000000000000000000000000000000022222222222222222222222222222222222222222222222222777
7722222222222222222222222222222222222222222222222222222222222222222222222222222222222222222222222222222222222222222222222222222222222222222222222222222222222222222222222222222222222222222222222222222222222222222222222222222222222222222222222222222222222222222222222222222222222222222222222222222222222222222222222222222222222222222222222222222222277777777777777777777777777777777777777777777777777777
7777777777777777777777777777777777777777777777777777777777777777777777777777777777777777777777777777777777777777777777777777777777777777777777777777777777777777777777777777777777777777777777777777777777777777777777777777777777777777777777777777777777777777777777777777777777777777777777777777777777777777777777777777777777777777777777777777777777777777777777777777777777777777777777777777777777777777
7777777777777777777777777777777777777777777777777777777777777777777777777777777777777777777777777777777777777777777777777777777777777777777777777777777777777777777777777777777777777777777777777777777777777777777777777777777777777777777777777777777777777777777777777777777777777777777777777777777777777777777777777777777777777777777777777777777777777777777777777777777777777777777777777777777777777777
