level:400 29
d
0000000000000000000000000000000000000000000000000000000000000000000000000000000000000000000000000000000000000000000000000000000000000000000000000000000000000000000000000000000000000000000000000000000000000000000000000000000000000000000000000000000000000000000000000000000000000000000000000000000000000000000000777777777777777777777777777777777777777777777777777777777777777777777777777777777777777777
0000000000000000000000000000000000000000000000000000000000000000000000000000000000000000000000000000000000000000000000000000000000000000000000000000000000000000000000000000000000000000000000000000000000000000000000000000000000000000000000000000000000000000000000000000000000000000000000000000000000000000000000777777777777777777777777777777778888888888888888888888888888888888888888888888888888888777
0000000000000000000000000000000000000000000000000000000000000000000000000000000000000000000000000000000000000000000000000000000000000000000000000000000000000000000000000000000000000000000000000000000000000000000000000000000000000000000000000000000000000000000000000000000000000000000000000000000000000000000000777777777777777777777777777777770000000000000000000000000000000000000000000000000000000777
0000000000000000000000000000000000000000000000000000000000000000000000000000000000000000000000000000000000000000000000000000000000000000000000000000000000000000000000000000000000000000000000000000000000000000000000000000000000000000000000000000000000000000000000000000000000000000000000000000000000000000000000777777777777777777777777777777770000000000000000000000000000000000000000000000000000000777
0000000000000000000000000000000000000000000000000000000000000000000000000000000000000000000000000000000000000000000000000000000000000000000000000000000000000000000000000000000000000000000000000000000000000000000000000000000000000000000000000000000000000000000000000000000000000000000000000000000000000000000000777777777777777777777777777777770000000000000000000000000000000000000000000000000000000777
0000000000000000000000000000000000000000000000000000000000000000000000000000000000000000000000000000000000000000000000000000000000000000000000222222222000000000000000000000000000000000000000000000000000000000000000000000000000000000000000000000000000000000000000000000000000000000000000000000000000000000000000777777777777777777777777777777770000000000000000000000000000000000000000000000000000000777
0000000000000000000000000000000000000000000000000000000000000000000000000000000000000000000000000000000000000000000000000000000000000000000000000000000000034000000000000000000000000000000000000000000000000000000000000000000000000000000000000000000000000000000000000000000000000000000000000000000000000000000000777777777777777777777777777777770000000000000000000000000000000000000000000000000000000777
0000000000000000000000000000000000000000000000000000000000000000000000000000000000000000000000000110000000000000000000000000000000000000000000000000000000056340000000000000000000000000000000000000000000000000000000000000000000000000000000000000000000000000000000000000000000000000000000000000000000000000000000777777777777777777777777777777770000000000000000000000000000000000000000000000000000000777
0000000000000000000000000000000000000000000000000000000000000000000000000000000000000000000000000000000000000000000000000000000000222222220000000000000000056563400000000000000000000000000000000000000000000000000000000000000000000000000000000000000000000000000000000000000000000000000000000000000000000000000000777777777777777777777777777777770000000000000000000000000000000000000000000000000000000777
0000000000000000000000000000000000000000000000000000000000000000000000000000000000000000000000000000000000000000000000000000000000000000000000000000000000056565600000000000000000000000000000000000000000000000000000000000000000000000000000000000000000000000000000000000000000000000000000000000000000000000000000777777777777777777777777777777770000000000000000000000000000000000000000000000000000000777
0000000000000000000000000000000000000000000000000000000000000000000000000000000000000000000000007117000000000000000000000222222200000000000000000000000000056565600340000000000000000000000000000000000000000000000000000000000000000000000000000000000000000000000000000000000000000000000000000000000000000000000000777777777777777777777777777777770000000000000000000000000000000000000000000000000000000777
0000000000000000000000000000000000000000000000000000000000000000000000000000000000000000000000000000000000000000000000000000000000000000000000000000000000056565600563400000000000000000000000000000000000000000000000000000000000000000000000000000000000000000000000000000000000000000000000000000000000000000000000777777777777777777777777777777770000000000000000000000000000000000000000000000000000000777
0000000000000000000000000000000000000000000000000000000000000000000000000000000000000000000000000000000000000000000000000000000000000000000000000000000000056565600565634000000000000000000000000000000000000000000000000000000000000000000000000000000000000000000000000000000000000000000000000000000000000000000000777777777777777777777777777777770000000000000000000000000000000000000000000000000000000777
0000000000000000000000000000000000000000000000000000000000000000000000000000000000000000000000222222220000000000000000000000000000020000000000000000000000056565600565656340000000000000000000000000000000000000000000000000000000000000000000000000000000000000000000000000000000000000000000000000000000000000000000777777777777777777777777777777770000000000000000000000000000000000000000000000000000000777
0000000000000000000000000000000000000000000000000000000000000000000000000000000000000000000000000000000000000000000000000000000000000000000000000000000000056565600565656563400000000000000000000000000000000000000000000000000000000000000000000000000000000000000000000000000000000000000000000000000000000000000000777777777777777777777777777777770000000000000000000000000000000000000000000000000000000777
0000000000000000000000000000000000000000000000000000000000000000000000000000000000000000000000000000000022222222222000222222222200000000000000000000000000056565600565656565600000000000000000000000000000000000000000000000000000000000000000000000000000000000000000000000000000000000000000000000000000000000000000777777777777777777777777777777770000000000000000000000000000000000000000000000000000000777
0000000000000000000000000000000000000000000000000000000000000000000000000000000000000000000000000000000000000000000000000000000000000000000000000000000000056565600565656565600340000000000000000000000000000000000000000000000000000000000000000000000000000000000000000000000000000000000000000000000000000000000000777777777777777777777777777777770000000000000000000000000000000000000000000000000000000777
0000000000000000000000000000000000000000000000000000000000000000000000000000000000000000000222222222220000000000000000000000000000000000000000000000000000056565600565656565600563400000000000000000000000000000000000000000000000000000000000000000000000000000000000000000000000000000000000000000000000000000000000777777777777777777777777777777770000000000000000000000000000000000000000000000000000000777
0000000000000000000000000000000000000000000000000000000000000000000000000000000000000000000000000000000000000000000000000000000000000000000000000000000000056565600565656565600565634000000000000000000000000000000000000000000000000000000000000000000000000000000000000000000000000000000000000000000000000000000000777777777777777777777777777777770000000000000000000000000000000000000000000000000000000777
0000000000000000000000000000000000000000000000000000000000000000000000000000002222222222200000000000000000000000000000000000000000000000000000000000000000056565600565656565600565656340000000000000000000000000000000000000000000000000000000000000000000000000000000000000000000000000000000000000000000000000000000777777777777777777777777777777770000000000000000000000000000000000000000000000000000000777
0000000000000000000000000000000000000000000000000000000000000000000000000000000000000000000000000000000000000000000000000000000000000000000000000000000000056565600565656565600565656563400000000000000000000000000000000000000000000000000000000000000000000000000000000000000000000000000000000000000000000000000000777777777777777777777777777777770000000000000000000000000000000000000000000000000000000777
0000000000000000000000000000000000000000000000000000000000000000222222222222000000000000000000000000000000000000000000000000000000000000000000000000000000056565600565656565600565656565634000000000000000000000000000000000000000000000000000000000000000000000000000000000000000000000000000000000000000000000000000777777777777777777777777777777770000000000000000000000000000000000000000000000000000000777
0000000000000000000000000000000000000000000000000000000000000000000000000000000000000000000000000000000000000000000000000000000000000000000000000000000000056565600565656565600565656565656340000000000000000000000000000000000000000000000000000000000000000000000000000000000000000000000000000000000000000000000000777777777777777777777777777777770000000000000000000000000000000000000000000000000000000777
0000000000000000000000000000000000000000000000000002222222222200000000000000000000000000000000000000000000000000000000000000000000000000000000000000000000056565600565656565600565656565656560340000000000000000000000000000000000000000000000000000000000000000000000000000000000000000000000000000000000000000000000000000000000000000000000000000000000000000000000000000000000000000000000000000000000000777
0000000000000000000000000000000000000000000000000000000000000000000000000000000000000000000000000000000000000000000000000000000000000000000000000000000000056565600565656565600565656565656560563400000000000000000000000000000000000000000000000000000000000000000000000000000000000000000000000000000000000000000000000000000000000000000000000000000000000000000000000000000000000000000000000000000000000777
0000000000000000000000000000000000000022222222222000000000000000000000000000000000000000000000000000000000000000000000000000000000000000000000000000000000056565600565656565600565656565656560565600000000000000000000000000000000000000000000000000000000000000000000000000000000000000000000000000000000000000000000000000000000000000000000000000000000022222222222222222222222222222222222222222222222222777
7722222222222222222222222222222222222222222222222222222222222222222222222222222222222222222222222222222222222222222222222222222222222222222222222222222222222222222222222222222222222222222222222222222222222222222222222222222222222222222222222222222222222222222222222222222222222222222222222222222222222222222222222222222222222222222222222222222222277777777777777777777777777777777777777777777777777777
7777777777777777777777777777777777777777777777777777777777777777777777777777777777777777777777777777777777777777777777777777777777777777777777777777777777777777777777777777777777777777777777777777777777777777777777777777777777777777777777777777777777777777777777777777777777777777777777777777777777777777777777777777777777777777777777777777777777777777777777777777777777777777777777777777777777777777
7777777777777777777777777777777777777777777777777777777777777777777777777777777777777777777777777777777777777777777777777777777777777777777777777777777777777777777777777777777777777777777777777777777777777777777777777777777777777777777777777777777777777777777777777777777777777777777777777777777777777777777777777777777777777777777777777777777777777777777777777777777777777777777777777777777777777777
